9 14
|------------|
|F.F|....P...|
|..........|.|
|.F...@|.....|
|......|.....|
|.F....|...|.|
|..|...|.....|
||.....|.||..|
|------------|